{
    "map_info": {
        "width": 10,
        "height": 10
    },
    "map_data": [
        [0, 1, 2, 1, 0, 0, 1, 2, 1, 0],
        [1, 2, 0, 0, 1, 2, 1, 0, 0, 1],
        [2, 0, 1, 2, 1, 0, 0, 1, 2, 1],
        [0, 1, 2, 1, 0, 0, 1, 2, 1, 0],
        [1, 2, 0, 0, 1, 2, 1, 0, 0, 1],
        [2, 0, 1, 2, 1, 0, 0, 1, 2, 1],
        [0, 1, 2, 1, 0, 0, 1, 2, 1, 0],
        [1, 2, 0, 0, 1, 2, 1, 0, 0, 1],
        [2, 0, 1, 2, 1, 0, 0, 1, 2, 1],
        [0, 1, 2, 1, 0, 0, 1, 2, 1, 0]
    ]
}
